[
    [1, 1, 1, 1, 1, 1, 1, 1, 1, 1, 1, 1],
    [1, [3, 400, 400], 0, 1, 4, 0, 0, 0, 1, 0, [3, 400, 400], 1],
    [1, 0, 0, 0, 0, 0, 0, 1, 0, 0, 1, 1],
    [1, 1, 0, 0, 0, 0, 0, 0, 0, 0, 0, 1],
    [1, 0, 1, 1, 1, 1, 1, 0, 0, 0, 0, 1],
    [1, 0, 2, 0, 0, 0, 0, 0, 0, 0, 0, 1],
    [1, 0, 0, 0, 0, 0, 0, 0, 0, 0, 3, 1],
    [1, 1, 1, 1, 1, 1, 1, 1, 1, 1, 1, 1]
]


